0000000000000
0101010101010
0101010101010
0101014101010
0101010101010
0000000000000
4011010101104
0000000000000
0101010101010
0101011101010
0101000001010
0101011101010
0000015100000