0000000000000
0201010101020
0101010101010
0101014101010
0201010101020
0000000000000
4033020203304
0000000000000
0101010101010
0101011101010
0101000001010
0101011101010
0000015100000